#################################
E   #     #         #       #   #
# # # ### # # ##### ### ### # # #
# # #   # # #   # #     # #   # #
# # ### # ##### # ####### ##### #
# #     #   #   #       #   #   #
# ######### # ####### # # # # ###
#         # # #     # #   # #   #
# ####### # # # ### ### ### ### #
#       # # #     #   # #     # #
# ####### # ######### # # ##### #
# #       # #       # # #   #   #
### ####### # ##### # ##### # ###
# #   # #   # # #   #     # # # #
# ### # # ### # # ####### # # # #
#     #       #           #     S
#################################
