###################################################
#                       #     #         #     #   #
# ######### ##### ####### # # ##### # # # ### # # #
#       #   #     #       # # #   # # # #   # # # #
##### ### ######### ####### # # # ### ##### # # # #
# #   #   #             #   #   # #   #   # #   # #
# # ### # # ############# ####### # ### # # ##### #
#   #   # #       #       # #   # # #   # #     #E#
# ### ########### # ####### # # # # # ### ##### ###
#   # #       #   #     #     #     #   #     # # #
### # # ##### # ####### ### ########### ### ### # #
#   #   #     #     # #   # #   #     # # #     # #
# ####### # ####### # ### ### # # # ### # ####### #
# #     # # #   #   #   # #   # # #   #   #       #
# # ### # ### # # ##### # # ### # ### ### # ##### #
#   #   # #   #   #     #   # # #   #     # #   # #
##### ### # ######### ####### # ### ####### # ### #
#   # #   #   #       #       #   #   #   # # #   #
# # ### # ### # # ##### ##### ### ### # # # # # ###
# #     # #   # #       #     # #   # # #     #   #
# ####### # ####### ##### ### # ### # # ######### #
# #     # #       #   #   #     #   # #     #     #
# # ##### ####### ##### ### ##### # # ##### # ### #
# #       #     #   #  S#     #   # #     # #   # #
# ### ##### # ##### # ### ##### ######### ##### # #
#   # #   # #     #   # # # #   #       # #     # #
### # # ### ### # ##### # # # ### # ##### # ##### #
#   # #     #   # #     # # #     # #     # #   # #
# ### ### ### ##### ### # # ####### # ##### # # # #
#   #   # #   #     #   #   # #     #       # # # #
### ### ### # # ##### # ### # # ############# ### #
#   #     # # # # #   # #   # # #             #   #
# ####### # # # # # ### # ### # # ### ######### ###
#     # #   # #   # # # #   # #   # # #       # # #
# ### # ### ##### # # # ### # ##### # # ##### # # #
# #   # #   #     # #     # #       # #     #   # #
### ### # ### ##### ##### # # ####### ##### ##### #
#   #     #   #   #   #   # # #       #     # #   #
# ##### ### ### ##### ### # # # ##### # ##### # # #
#     # #   #       #   # #   #     # # #       # #
# ### ### ### ##### ### # ### ##### ### # ####### #
#   # #   #   #     #   # #   #     #   # #       #
##### # ####### ##### ### # ### ##### ### # #######
#     # #       #   #   # #   #     # #   #       #
# ### # # ##### # # ### # ### ##### # ########### #
# #   #   # #   # # #   # #   # #   # #     #     #
# ######### # ### # # # ### ### # ### # ### # #####
# #     #   #   # #   # #   #   #   # # #   #     #
# # # ### # ### # ####### ### # ### # # # ####### #
#   #     #     #             #   #     #         #
###################################################
