#########################################################################################################################################################################################################
# # #       #   # #     #           # # #   # # # #   #     # #         # #   #     # #                 #   #   #       #         # #   #       #     # #       #   #   # #         #   #     # #   #   #
######### ### ### # ### # # ##### ### ### ### # # ### # ### # # # ##### # # # ### # ### # ##### # ### ### # # ####### # # # ##### # # # ### ### # ##### ### # # # # # ##### ##### ### # ##### # # # # # #
#   #           #   # # # # #     #       #         #   # #     # # #   #   # #   # #   # #     # # # #   #   #     # #   # # #   # # #     # # #     # # # # #   #   #     #     #   # #     # # #   # #
# ### ######### # ### # # # ####### # ##### # ##### # ### ####### # # ### ### ### # ### ##### ##### # # ####### ### # ##### # # ### # ##### # # # ### # # ##### ##### # ##### ### # # # # ### # ### # ###
#   #   # #     # #   #   #     #   #     # #     # #         #   # #     # #   # #     #   #     #     #   #     #   #   #   # #     #     #   # # #           # #     #   #   # # # # # # #   # # #   #
# # ### # # ##### ### ######### # ### ### # ##### # ####### ### ### ####### ### # ##### # # ########### ### # ######### ### ### # ##### ######### # ### ####### # # ##### # ####### ### # # ### # # # ###
# #   # # #   #   #   #     #   #   # # # # #     #   #   # #     #   #   #   # #     # # # #         # #   # #     #     #   #   #     # # #   #   # #       # #       # #         # # # # # # #   #   #
##### # # ### # ### ### ### # ##### # # # # ### ##### # ### ##### # ##### # ### # # ### # # # ####### # # ### ##### # # ### # ####### ### # # # ### # # ### # ####### ### ########### # # # # # # ### # #
#   # #     #   # #     #   #     # #   #   # # #     #     #     # #         # # # #   # # #       # # #   #     #   #   # # #             # #     # # #   #   # #     # #     #     #   #   #   # # # #
# # # # ######### ####### ##### # # ### ### # # ##### ##### # ##### # ####### # ### # ### # ####### # # # ####### # # ### ### # ######### ### ####### ### # ############# # ### ##### ##### # ##### # ###
# #   #     #     #           # #   #     #   #     #     # # #             # #   # #   # #   #   # # #   #     # # #   # #   #       #   #   #   #   #   #   # # #E    # #   #       #     #   # # # # #
# ######### # # ### # ####### ##################### ##### ### ##### # ####### ### # ##### ### # # # # ##### ### # ### # # # ##### ######### ### # ### # ####### # ##### # ##### ##### ##### ### # # # # #
#         #   # # # # #             #             # #   #   # #     # #         # #   #   #   # # # #     #   # #   # # # # #     # #       # # #   # #         #     #   #     #     #     #   # #   # #
##### ### ##### # # ############# ### ##### # # # # # ##### # # ####### ######### # ### ##### # # # ### # # ### ### ### # # # ##### # ####### ##### # ##### # ### ### ##### ######### # ####### # # ### #
# #   #     #   #   #     # #   # # #   #   # # #   #     # # #       #     #   # #   # #     # #     # #     #   #     # # #       # #   #   #         # # # #   # # #       #     # #       #   #   # #
# # # ### ### ### # # ### # # ### # ### ############# ### # # ####### ##### # # # # # # # ##### ########### ### ######### # ######### # # # # # # # ### ### # # # # # ####### # ### # # ##### ### ### # #
#   # # #   # #   #   # # #     #   # #         #   # # # # # #       #   #   # # # #   #   # #       #   # #   # # #     #   #       # #   #   # #   # #   #   #   #   #     # #   # # #   #   # #   # #
##### # ### # ####### # # ##### ### # # # ##### ### # # # # # ##### ### # # ### # ##### ### # ### ##### # ### # # ### ####### # ########### ####### ##### ########### # ### ### # ### # # # # ##### ### #
# #   #   # #   #   #   # #       #   # #     #   #     #   #     # #   # # #   #   # #   #     # #     #   # #     #     # #   #   #   #   #   #   #   # #           #   #   # #     # # #   #   # #   #
# # ### ### ### # ### ### # # ####### ######### # # ##### ### ### # # ### ### ##### # ### # ##### # ####### # ##### ##### # ##### # # ### ### # # ### # ### ##### # ##### ### ####### ### ##### # # # # #
#   #     #   # #   # # # # #       # #   #   # # # #   # # # #   # # #     #       # #   # #     # #     # #     #     # #     # #     #     # #   # #     #     # #       #     #         #   #   # # #
# ##### # # ### ### # # # ### # # ### # # # # ### # # # # # ### ### # ### ########### # ### # ##### ##### # # ### ##### # # ### ### ### ### ##### ### ##### # ### ######### # ### ######### # ####### # #
#     # #   # # #   #   # #   # # # #   # # #     # # # # # #   #       #   # # #       # #     #     #     #   #     # #   # #   #   #   # #       # #   # #   # #     # # # #       #     # # # # # # #
##### ### ### # # ##### # ### # # # ### ### ##### ### # # # # ######### ##### # ### ##### ####### ####### ##### ##### ####### ### ### ### # # ##### # # # ##### ### ### # # ### ##### # ##### # # # # ###
#     #       # #       #   # # # #   # # #     #   # # #       #   #     #       #       #  S#   #       #         #   #   #     # # #   # # #     #   #     # #     # #     #   #   # #   # #   #     #
# # ### ####### ### ####### ### # # # # # ##### ##### # ### ##### # ##### # ##### ##### ### # # ### ######### ##### # ### # # ######### # # # # ############# ### # # ####### ### ##### # ### ### ##### #
# # #   #       # # # #   #   # # # # # # #     #     #   #   #   # #   # #   #       # #   # # # # #       # #   # #     # #     #   # # # # # #     #   # #   # # #   #     #   #   #     # #         #
# ##### # ####### # # # ##### # ### ### # # ##### ####### ##### ### ### # ### ####### ### ### # # # # ### # ### # ####### ####### # # # ### # ### ### # ### # # # ##### ##### # ##### # # ### # # # # # #
#     # #     #   # #   #     #     # #   # #   #       #     #   # #     #   #     #     # #   #   #   # #     #               #   # #     #       #       # # # #   #     #     #   # # #   # # # # # #
# ### ####### # # # # # # # ##### ### ### # # # ####### ### ##### # ##### # ### ########### ##### ### ### # ######### ### ### ####### ### ####### ### ##### # ### ### ##### ####### ### ### ##### #######
# #     #     # #     # # # #     #     # # # #   #     # #       #   # #   # #     # #   #     # #   #   # #       # #   #   #   #   #         # #   #     # # #     # # #   #   # #   #   # #         #
# # ### # ############### ##### # # ### # # # ### # ##### ########### # ##### ### # # # ### ##### ##### ### # ##### ##### # ### # # ### ### ####### ### ##### # ##### # # ### # # # # # # ### ##### ### #
# # # # # # #   # # #     #     # #   #   #   # #   # # #         #   #   #       # #         #         #   #     # #   # # #   #   #   #   #     # #     # #     # #   # # #   # #   # #   #   #   # # #
### # # # # ### # # ##### ### # # ### ######### ##### # ### ##### # ### ##### # ### # ##### # # # # ######### ##### # # ####### ########### ### # ### ### # ### ### ### # # ##### # ##### # # # # ### # #
#   #   #   #           #   # # # #         #   # #       #     # # #   #     #   #   #   # #   # # #         #     # #   #   # #         # # # # #   # # #   #       #   #     # #   #   #   #   # #   #
# # ####### ### # ##### ### # ##### ####### # # # # ### # # # # # # ### # ####### ### # # ##### ##### ######### ##### ### # # # ####### # ##### # ### # # # ######### # # ### ### ### ### ######### # ###
# # #   #   # # # # #       #       #       # # #   #   # # # # # # #     #   #     # # #   #     # # #   # # #         #   # #   #     #       # # # # # #         # # #     #   #     #   # #       # #
# # # # # ### ### # ##### ####### ### ######### ##### ### ####### # ####### # ######### ### ####### # ### ### # ##### ##### # ### # ### ######### # # # # ####### ### # ####### ######### # # # ##### # #
# #   #           #       #         #                 #           #         #           #                     #     #   #   #       #   # # #         #             #     # #             # #   #       #
#########################################################################################################################################################################################################
