#####################################################################################################
#       #   #       #           #   #     #         #   #         #           #   #               # #
# ##### # # # ### # ####### ### # # # # ### ####### # # # # ##### # ######### # # # ######### ### # #
# #   #   # # #   # #   #   # #   # # #       #     # # # #     # #     #   # # # # #         # #   #
# # # ##### # # ### # # # ### ##### ########### ##### # ####### ### ##### # # # # # # ######### ### #
# # #   #   # #   #   #   #   #   # #   #     # #   # #   #     #   #     # #   #   #   #     #     #
# ### # # # # ### ######### # ### # # # # ### # # # # ### # ##### ### ##### # ######### ##### # #####
#   # # # # #   #     #     #     #   # #   # # #E# # # # #     #   # #   # #     #     #   # # #   #
### # # # ##### ##### # # ####### ##### ### # # ### # # # ##### # ### # # # ##### # ##### # # # ### #
# # # # #     # #   # # # #   #   #   #     #     #   # #     #   #   # # #     # #   #   #   #   # #
# # ### ### # # # # # # ### # # ### # ########### ##### ##### # ### ### ####### ##### # ######### # #
#       #   # # # # # # #   # #     # #         # # #       # # #   #         # #     #     #     # #
######### ### # # ### # # ### ######### ####### # # # ### ### # # ####### ##### # ##### ### # ##### #
#         #   #   #   #   # #     #   # #     # #   #   #     # # #       #     # #     #   #       #
# # ####### ##### # ### ### ##### # # # # ##### ### ### ######### # # ##### ##### # ##### # ####### #
# # #   #   #   # # #   #   #     # # # #     #   #   #     #     # #     #       #     # # #     # #
# ### # # ### # # # # ##### # ### # # # # ### # # ### ##### # ##### ##### ############# # # # ### # #
#     # #     # # # #       # #   # #   #   # # # # # #   #   #   # #   #     #   #   # # # #   #   #
####### ######### # # ####### # ### ######### # # # # ### ####### # # # ### ### # # # # # ##### #####
#   #   #         # # #   #   #   #   #     # # #   #         #   # # #   # #   #   #   #     #   # #
# # # # # ######### ### # # ######### # ### # # ### ######### # ### ##### # # ############### ### # #
# #   # # #       #     # #         # #   #   #   #         # #   #     # #   #           #     #   #
# ##### # ### ### ##### # ######### # # # ####### ##### ##### ### ##### # ############### # # ##### #
#     # #   # #   #   # # #     #   # # #       #   #   #     #   #   #     #             # # #   # #
# ### ##### # ##### # ### # ### # # # ##### # ##### ##### ##### # # ####### # ### ######### ### # # #
# # #     #   #     #   # # #   # # #     # #   #   #     #   # #   #       #   # #       #   # #   #
# # ##### # ### ####### # # # ### # ##### # ### # ### ##### # # # ### ######### # # ##### ### # #####
# #   # #   #   #     #   # #     #   #   # #   #     #     #   # #   #       # # # #   # #   # #   #
# # # # ##### ##### ####### ########### ### # ######### # ####### # ### ### # # # # # # # # ### ### #
#   # #   #   #   # #       #           #   #           # #     # #   # # # # # # #   # # #   #     #
##### # # # ### # # # # ### # ##################### ##### # # ### ### # # # # # ####### # ### ##### #
#   # # # # #   # #   # #   # #     #             # #     # # #   #   #   # #   #     # #   #       #
# ### # # # # ### ##### # ### # # # ### ######### # # ##### ### ### ##### # ##### # ### ### #########
#   #   # #     # #     #   # # # #   #   #   #   # # #   #       # # #   #       #     #     #   # #
### ##### ####### # # ####### # # ### ### # # # ##### # ### ####### # # ########### ##### ### # # # #
#   #       #   # # # #   #   # #   #     # # #     # #       #     #   #         #   #   #   # #   #
# ### ####### # # # ### # # ####### ######### ##### # ######### ######### ####### ##### ### ### #####
# #     #     # # #     #   #     #   #     #   #   # #         #       # #     #   #   # #   #     #
# # ##### ##### # # ########### # ### # ### # # # ### # ######### # ### # # ### ### # ### ### # ### #
#   #   #   # #   # #           #     # # #   # #     #       #   #   #   # #     #   #     # #   # #
##### # ### # ##### # ####### ######### # ##### ##### ####### ####### ##### # ########### # # # ### #
#     #     #     # #     #   #     #   # #   # #   # #     #         #   # # #     #     # # # #   #
# ############### # ####### ### ### # # # # # # # # # # ################# # # # # # # # ### # # # ###
# #     #         # #   #   #   #   # # #   #   # #   #                   # # # # # # #   # # # #   #
# # ### # # ##### # # # # ### ####### # ####### # ##### ########### # ##### # # # # # ### # # ##### #
#   #   # # #   # # # #   #         # #       # # #   #   #   #     # #   # #   # # #   # # #   #   #
##### ### ### # ### # ############# # ####### # # # # ### # ### ####### # # ##### # ##### # ### # # #
#     #   #   #   # #   #         # # #     # # #   #   # #   #     #   #     #   #     # # #   # # #
# ####### # ##### # ### # ####### # # # ### # # ####### # # # ##### # ####### # ####### # ### ### # #
# #     #       #       # #   #   # #   #   # #     #   # # #     #     #   # # #       #   #   # # #
# # ### ################# # # # ### ##### ### ##### # ### ####### ####### # # # ### ####### ### # # #
# # # #                   # # # #     #   # #     # # # # #   #     #   # # # #   #       #   # # # #
# # # ##### ############### # # ##### # ### ##### ### # # # # # ### # # # # ##### ####### # # # # # #
# #   #   #             #   #   #   #   #     #   #   #     #   #   # #   #       #         # # # # #
# ### # # ##### ######### ####### # # ### ##### ### ############# ### ########### ########### # # # #
#   # # #   #   #         # #     # #     #     #   #     #     #   #     #   # # #       #   #   # #
# ### # ### ##### ######### # # ### ####### ### # ### ### ### # ### ##### # # # # # ##### ######### #
#   # #   #     # #           # #       #   # # #   # # #   # #     #   # # # # # #   # #       #   #
### # ### ##### # # ########### ####### # ### # ### # # ### # ####### # # # # # # ### # ##### # # ###
#   #   #     #   #   # #     # #   #   # #   # # #   # #   #       # #   # # #   #   #     # # #   #
# # ### ##### ####### # # ### # # # # ### # ### # ##### # ######### # ### # # ### # ####### # ##### #
# #   #     #       #   # #     # # #     # #   #   #   #   #   #   #   # # #   # # #     # #     # #
# ######### ####### ### # ####### # ####### # ### # ### ### # # ####### ### ### # # ### # # ##### # #
#     #       #   #   # # #   #   #       # # #   #     # #   #         #   #   # #   # #   #   # # #
# ### # ####### # ### ### # # # ##### ### # # ### ##### # ######### ##### ### ### ### # # ### # # # #
# # #   # #     #   #   #   # # #   # #   #       #   #           # #     #   # #   #   # #   #   # #
# # ##### # ####### ### ### # # # # ### # ######### ### ########### # ##### ### ### ##### # ### ### #
#         #   #   #   #   # # # # #     # #   #         #           #   #   #   #   #   # # #   #   #
####### ##### # # ### # # ### # # ######### # ### ####### ############# # ### ### ### ### # # ### ###
# #     #     # #   # # #   # # # #         #   # # #             #   # #   #   #   #   # # #   #   #
# # ##### ##### # ### ##### # # # # ########### # # # ############# # # ### # # ### # # # # ### ### #
#   #   #   #   #           # # # #       #     #   # # #           # #   # # #     # # # #   # #   #
# ##### ### # ############### # # ### ##### ### ##### # # ########### # ### # ##### ### # ### ### ###
#         # #     #    S# #   # #   # #     #   #   #   #         #   # #   # #   #     # # #     # #
### ####### # ##### # ### # # # # ### # ##### ### # # ########### # ### # # ### # ####### # ####### #
#   #       # #     # #     #   #     #   #   #   # # #     #     # #   # # #   # #       #     #   #
# ### ######### ##### # ####### ######### ##### ### # # ### # ##### # ### ### ### # ####### # # ### #
#   #   #       #   # # #     #     #   #       # #   # # #   #   # #   # #   #   #   #   # # #     #
# ##### # ####### # # ### ### ##### ### ######### ##### # ##### ### ### # # ### # ### ### # # ##### #
# #     # #     # # #   # # #   # #     #           #   #   #     # #   #   # # #   #   #   #   #   #
# # ### # # ### ### ### # # ### # ##### ########### # ##### # ### # # ####### # ### ### ####### ### #
# #   # # # # #     # # #     # #     #   #     #   #     #   #   #   #   #   #   #   #       #   # #
# ### ### # # ##### # # ##### # # # ##### # ### # # ##### # ### ####### # ### ### ### ####### # # # #
#   #     # #   #   # #   #   # # # #   #   # #   # #   # #   #       # #       #   # #   #   # # # #
### ####### ### # ### # # # ### # ### # ##### ##### ### # ### ##### # # ####### ### # # # # ##### # #
# #     #     #   #   # # # #   #     #           #     # #     #   # #   #     #   # # # # #   # # #
# ##### ##### # ### ### ### # ### ############# ####### # ####### ### # # ### ### ### # ### # # # # #
# #     #     #     #   #   #   # #           #       # # #       #   # #   #   #   #   #   # #   # #
# # ##### ####### ### # # ##### # ### ######### ##### # # # ######### ##### ### ### # ### ### ##### #
# # #     #       #   # # #   # #     #   #   #     # # # #         #       # # #   # #   #     #   #
# # # ##### ####### ##### # # # ##### # # # # ##### # # # # ####### ######### # # ##### ### ### #####
#   #     # #     #   #   # # # #     # #   # #     #   # # #     #   #     #   #     # #     # #   #
# ####### # # # ##### # ### # # # ##### ##### # ######### # # # ##### # ### # ####### # ####### # # #
#       # #   # #     # #   # # # #   # #     # #   #     # # # #     #   #   #   #   # #     #   # #
####### # ##### # ##### # ### # ### # # # ##### ### # ##### # # # ####### ##### # # ### # ### # ### #
#     #   #     # #   # # #   #     #   # #         # #       # # #     # #     # #   #   #   # #   #
# # ####### ##### # # # # # ############# # ######### ########### ##### # # ##### ### ##### ##### # #
# #     #   # #   # #   # # #     #   #   #   #   #   #   #     #     #   #     #   #       #     # #
# ### ### ### # ### ##### # # ### ### # ####### # # ### # # ### ##### # ########### ########### ### #
#   #         #           #   #       #         #       #   #         #                         #   #
#####################################################################################################
